22
16
1111111111111111
1000000000000001
1000000000000001
1000000000000001
1002222002222001
3000000000000001
1000000000000001
1002222002222001
1000000000000001
1000000000000001
1002222002222001
1000000000000001
1000000000000001
1002222002222001
1000000000000001
1000000000000001
1002222002222001
1000000000000001
1000022222200001
1000000000000001
1000000000000001
1111111111111111